&&&&&&&&&&&&&&&&&&&&&&&&&&&&&&&&&&&&&&&&&&&&&&&&&&&&&&&&&&&&&&&&&&&&&&&&&&&&&&&&&&&&&&&&&&&&&&&&&&&&&&&&&&&&&&&&&&&&&&&&&&
&                                                                                                                        &
&                                                                                                                        &
&                                                                                          +                             &
&                                                                                                                        &
&                           +          +                                                                                 &
&                                                                                                                        &
&                                                                                                                        &
&                                                                                                                        &
&                                                                                                                        &
&                                                                                                                        &
&                                                                                                                        &
&                                                                                                                        &
&                                                                                                                        &
&                                                                                                                        &
&                                                                                                                        &
&                                                                                                                        &
&                                                                                                                        &
&                                                                                                                        &
&                                                                                                                        &
&                                                                                                                        &
&                                                                                                                        &
&                                                                                                                        &
&                                                                                                                        &
&                                                                                                                        &
&                                                                                                                        &
&                                                                                                                        &
&                                                                                                                        &
&                                                                                                                        &
&                                                                                                                        &
&                                                                                                                        &
&                                                                                                                        &
&                                                                                                                        &
&         +         +                                                                                                    &
&                                +                                                                                       &
&                                                                                                                        &
&&&&&&&&&&&&&&&&&&&&&&&&&&&&&&&&&&&&&&&&&&&&&&&&&&&&&&&&&&&&&&&&&&&&&&&&&&&&&&&&&&&&&&&&&&&&&&&&&&&&&&&&&&&&&&&&&&&&&&&&&&
